8 25
-2  0  0 -2  0  0  0  0
 0  0  0  0 -2  0  0  0
 0  0 -4  0  0  0  0  0
 0 -5 -6  0  1  0  0  0
 0 -5  2 -6  0 -8  0  0
 0  0  0  0  0  0  0  0
 0  0 -3  0 -7  0 -9  0
 0 -1  0  0  0  2  0  0
 0 -1 -1  0  0  0  0  0
-1 -1 -1  0 -1  0 -1  0
 0 -1 -1  0 -1 -1  0  0
 0 -1  0  0 -1  0 -1  0
 0  0  0  0 -1 -1  0  0
 0  0  0  0 -1  0 -1  0
 0 -1  0  0 -1  0 -1  0
-1 -1  0  0 -1 -1  0  0
-1 -1 -1  0 -1  0 -1  0
-1 -1  0  0 -1 -1  0  0
 0 -1  0  0 -1  0 -1  0
 0  0  0  0 -1 -1  0  0
 0  0  0  0 -1  0 -1  0
 0  0  0  0 -1 -1  0  0
 0  0  0  0 -1 -1 -1  0
 0  0  0  0 -1 -1  0  0
 0  0  0  0  0  0  0  0
 3
 20 3
 0 2
