13 40
-1  -1  -4  -1  -1  -1  -1  -1  -1  -1  -1  -1 -1
-1  -5  -6  -1  -1  -1   1  -1  -1  -1  -1  -1 -1
-1  -5   0  -6  -1  -1   1   1  -1  -1  -1  -1 -1
-4   0   0  -4  -1  -1   0   0   1  -1  -1  -1 -1
-1  -6   0   0  -1  -1   0   0   1   1  -1  -1 -1
-1  -6   0   0  -1   0   0   0   1   1   1  -1 -1
-1  -1  -4   0   0   0   0   0   0   1   1  -1 -1
-1  -1  -1   1   0   0   0   0   0   1   1  -1 -1
-1  -1  -1   1   1  -3   0   0   0   1   1  -1 -1
-1  -1   1   1   1   0   0   0   0   1   1   1 -1
-1  -2   1   2   1   1   0   0   0   0   1   1 -4
 0   0   1  -3   1   1   1   1   0   0   1  -5 -1
 0   0   1   1   1   1   1   1   0   2   1  -5 -1
 0   0   1   1   1   1   1   0   0   1  -4  -1 -1
 1   0   1   1 -10   1   1  -3   0   1  -5  -6 -1
 1   1   1  -8 -10   1   1   0   1  -5   0  -6 -1
 1   1  -2 -10 -10 -10   1   0   1  -5   0  -2 -6
 1   1  -7  -8  -9 -10   1   1  -5   0   0   0 -4
 1   1  -7 -10 -10  -9 -10   1  -5   0   0   0 -5
 1   1  -7 -10  -9 -10   1  -4   0   0   0  -5 -1
 1   1   1 -10   2 -10   1   0   0   0   0  -5 -1
 1   1   1   1   1   1   0   0  -4   0  -4  -1 -1
 1   1  -3   1   1   1   0   0   0  -6  -5  -6 -1
 1   1   1   1  -3   1   0   0   0  -4   1  -6 -1
 1   1   1   1   1   1   0   0   0   0   1   2 -6
 1   1   1   1   1   1   0   0   0   1   1   1 -4
 1   1   2   1   1   1  -1   0   0   1 -10   1  1
 1   1   1  -3   1  -1  -1   0   1  -8 -10   1  1
-4   1   1   1   1  -1  -1  -1   1 -10 -10 -10  1
 0   0   1   1   0  -1  -1  -1  -7 -10  -9 -10  1
-4   0   0   0   0   0  -1  -2  -4 -10   1 -10  1
 0   0   0   0   0   0   0  -5   1   1   1   1 -2
-4   0   0   0   0   0   0  -5   1   1  -1   1 -1
-4   0   0   0   0   0  -5   1  -1  -1  -1  -1 -1
-1  -6   0   0   0   0  -5   1  -1  -1  -1  -1 -1
-1  -6   0   0   0  -5   1  -1  -1  -1  -1  -1 -1
-1   1  -6   0  -2  -5   2  -1  -1  -1  -1  -1 -1
-1   1  -6   1  -5   1   1  -1  -1  -1  -1  -1 -1
-1  -1  -1  -6  -5   1  -1  -1  -1  -1  -1  -1 -1
-1  -1  -1  -4   1  -1  -1  -1  -1  -1  -1  -1 -1
 37 6
 6
 18 9
 30 10
 21 4
 4 8
 2 2
